12 22
######################
# #  #   #           #
# #   #  #  #####    #
# #####  #      #    #
#        ######### ###
#  # ##      #       #
#  ########  # ##### #
## ##        # #     #
## ### ############# #
#  #        #     #  #
#       #      #     #
######################
