26 46
##############################################
#                                            #
#   ###                                ###   #
#   ###                                ###   #
#   # #                                # #   #
#                                            #
#                #############     #         #
#               ##############      #        #
#               ####        ###      #       #
#    #          ####        ###       ####   #
#    ##  #      ####                 #       #
#    ##  #      ####                #        #
#    ######     ####               #         #
#    ##  #      ####                #        #
#    ##  #      ####                 #       #
#    #          ####        ###       ####   #
#               ####        ###      #       #
#               ###############     #        #
#                #############     #         #
#                                            #
#                                            #
#    # #                               # #   #
#    ###                               ###   #
#    ###                               ###   #
#                                            #
##############################################
